99999999999999999999999999999999
90000000000000000000000000000009
90000000000000000000000000000009
90000000000000000000000000000009
90000000000000000000000000000009
90000000000000000000000000000009
95000000000000000000000000000009
99999999999999999999999999900009
90000000000000000000000000000009
90000000000000000000000000000009
90000000000000000000000000000009
90000000000000000000000000000099
90000000000000000000000000000009
90000000000900000900090000900099
9000000000000f00f0000000000f0009
90000000093333333333333333333339
99999999999999999999999999999999