11111111111111111111111111111111
10000000000000000000000000000001
10000000000000000000000000000001
10000000000000000000000000000001
10000000000000000000000000000001
10000000000000000000000000000001
10000000000000000000000000000001
10000000000000000000000000000001
10000000000000000000000000000001
10000000000000000000000000000001
10000000001000010000000000000001
10000000001000010000000000000001
10000000001000010000000000000001
10000000001000010000000000000001
10000000000000010000000000000001
10000060000000010000000000000051
12222222222222212222222222222221