11111111111111111111111111111111
10000000000000000000000000000001
10000000000000000000000000000001
10000000000000000000000000000001
10000000400000040000000400000051
10002222222222222222222222222221
10000000000000000000000000000001
10000000000000000000000000000001
10000000000000000000000000000001
10000000000400000004000000000001
12222222222222222222222222000001
10000000000000000000000000000001
10000000000000000000000000000001
10000000000000000000000000000001
10000000000000000000000000000001
10000077000000000000000700770001
12222211222222222222222122112221