11111111111111111111111111111111
10000000000000000000000000000001
10000000000000000000000000000001
10000000000000000000000000000001
10000000000000000000000000000001
10000000000000000000000000000001
10000000000000000000000000000051
10022277222200002222002772222221
10000000000000000000000000000001
10000000000000000000000000000001
10000000000000000000000000000001
10000000000000000000000000000001
11200000002000002222277222220001
10000000000000000000000000000001
10000000000000000000000000000001
10000000000000000000000000000021
12222277212222122772212222222211