11111111111111111111111111111111
10000000000000000000000000000001
10000000000000000000000000000001
10000000000000000000000000000001
10000000000000000000000000000001
10000000000000000000000000000001
15000000004000000000000000000001
11111111111111110000000000000001
10000000000000000001000000000001
10000000000000000000000000000001
10000000000000000000000040000001
10000000000000000000001111110001
10000000000000000000000000000001
10000000010000100001000000000001
10000000000000000000000000000001
10000001333333333333333333333331
12222221111111111111111111111111