11111111111111111111111111111111
10000000000000000000000000000001
10000000000000000000000000000001
10000500000000000000000000000001
10000222000000000000000000000001
10000000000000000000000000000001
10000000000002222222000000000001
10000000000000000000000002000001
10000000000000000000000000000001
10000000000000000000002000000001
10000000000000000000000000000001
10000000000000200002000000000001
10000000000000000000000000000001
10000000020000000000000000000001
10000000000000000000000000000001
10000277777777777777777777777771
12222222222222222222222222222221