99999999999999999999999999999999
90000000000000000000000000000009
90000000000000000000000000000009
90000000000000000000000000000009
90000000000000000000000000000009
90000000000000000000000000000009
90000000000000000000000000000009
90000000000000000000000000000009
90000000000000000000000000000009
90000000000000000000000000000009
90000000000000000000000000000009
90000000000000000000000000000009
90000000000000000000000000000009
90000000000000080000000000000009
90000000000000000000000000000009
90000000000000000000000000000009
99999999999999999999999999999999