99999999999999999999999999999999
90000000000000000000000000000009
90000000000000000000000000000009
90000000000000000000000000000009
90000000000000000000000000000059
90999999999999999999999999999999
90000000000000000000000000000009
90000000000000000000000000000009
90000000000000000000000000000009
99090900900900909000900000000009
93333333333333333333333390000009
99999999999999999999999999990009
90000000000000000000000000000009
90000000000000000000000000000009
90000000000000000000000000000099
900000000r000f0000f0000r00000009
99999999999999999999999999999999